F 160,160,160 

SO textures/mossy.xpm
EA textures/azouz.xpm
NO textures/greystone_dark.xpm
WE textures/greystone.xpm
 

C 0,0,204



1111111111111111111111111111111111111111111111111111111111111
1N000000000000000000000000000000000000000000000000000000000001
1111111111111111111111111111111111111111111111111111111111111