F 0,0,0

EA textures/azouz.xpm
SO textures/mossy.xpm
NO textures/greystone_dark.xpm
WE textures/greystone.xpm


C 0,0,255


1111111111111111111111111111111
 1111111000100011110000000000001                           
1010000100000101111111111111111
10000000000E0000000001
10001000100010000000001
10000000010000001111111
1010101001010101
11110000000000001
1111111110001111
111111101011111
1111000100000001
10000000000000001
10100000100001001
100000000000000011
111111111111111111