F 160,160,160 

SO textures/mossy.pm
EA textures/azouz.xpm
NO textures/greystone_dark.xpm
WE textures/greystone.xpm
 

C 0,0,204




 


111111111  111111
10001000111100001                           
1011000010000010111111
10000000000000000000001
10001000100010000000001
10000000010000001111111
10101010N01010101
11110000000000001
1111111110001111
1111111111011111
1111000100000001
10000000000000001
10100000100001001
10000000000000001
11111111111111111