F 0,0,4

EA textures/azouz.xpm
SO textures/mossy.xpm

C 0,255,0
NO textures/greystone_dark.xpm
WE textures/greystone.xpm



   

                        1
                       101
1111111111111111111111111
100000000000000000000001
100000000000000000000001
100000000000000000000001
100000000000000000000001
100000000000000000000001
10000000N000000000000001
100000000000000000000001
100000000000000000000001
100000000000000000000001
100000000000000000000001
100000000000000000000001
100000000000000000000001
111111111111111111111111